   *******************************
         *  *  *  *              *
*  *******  *  *  *  *******  *  *
*        *  *              *  *  *
*******  *  *******  **********  *
*     *  *  *  *           *     *
****  *  *  *  **********  ****  *
*  *           *              *  *
*  *  *  *  *******************  *
*  *  *  *  *  *     *  *     *  *
*  *  ****  *  *  ****  *  *  *  *
*  *     *  *  *        *  *     *
*  *  ****  *  ****  ****  ****  *
*  *  *           *        *     *
*  *  *  ****  ****  *******  *  *
*     *     *        *        *  *
*  **********  *  **********  ****
*     *     *  *     *  *        *
*  *******  *  *******  *******  *
*     *  *     *                 *
****  *  *  *  ****  ****  *  *  *
*     *     *  *        *  *  *  
*******************************  


