   ****************************
            *     *           *
*******  *  *  ****  *  ****  *
*  *  *  *     *     *  *  *  *
*  *  *  *************  *  ****
*     *        *  *           *
*  *  *  ****  *  *  *  ****  *
*  *     *  *  *  *  *  *  *  *
*  ****  *  *  *  *  ****  *  *
*     *  *     *     *        *
*  **********************  *  *
*     *        *  *     *  *  *
****  ****  ****  *  *  ****  *
*  *  *  *           *  *     *
*  *  *  *  *  *  ****  *  ****
*  *  *     *  *     *  *  *  *
*  *  ****  ****  *  *  *  *  *
*              *  *  *  *     *
*  *******  *  ****  *  *  ****
*        *  *  *     *        
****************************  


