   j************************************
         *           *  *        *  *  *
****  *  *  ****  ****  *******  *  *  *
*     *     *           *        *     *
*  ****  ****  ****  ****  *******  ****
*  *        *  *        *  *        *  *
*******  *  *******  *  *  *  ****  *  *
*        *  *     *  *  *        *     *
****************  *  *  ****  *******  *
*  *  *     *  *  *  *     *  *  *     *
*  *  ****  *  *  *  ****  *  *  ****  *
*        *        *  *  *           *  *
*  *************  *  *  ****************
*        *  *        *           *     *
*  *  ****  *  *  ****  ****  ****  *  *
*  *        *  *           *        *  *
*******  ****  *******  *  ****  *  *  *
*  *  *        *        *  *     *  *  *
*  *  *******************  *  **********
*  *           *     *  *  *           *
*  **********  ****  *  **********  *  *
*                                *  *  *
*  *  *  *******  *******  *******  *  *
*  *  *  *     *  *           *  *  *  *
*  ****  *  *  ****  *******  *  ****  *
*  *        *     *        *           
*************************************  
