   ****************************************
            *  *                    *     *
*  ****  ****  *******  *******  ****  ****
*     *  *  *     *     *           *     *
*  ****  *  *  *******  ****  *  *******  *
*     *           *        *  *     *     *
*******  *  ****  *  ****  *  *******  ****
*        *  *     *  *     *        *     *
*  *  **********  *  ****************  ****
*  *  *        *     *        *  *  *     *
**********  *  *  *******  *  *  *  ****  *
*           *  *           *     *        *
**********  **********  **********  ****  *
*  *           *  *     *  *        *     *
*  *******  ****  ****  *  *  ****  *  ****
*           *  *           *  *  *  *     *
****  ****  *  **********  ****  *  *  ****
*        *  *     *  *     *  *     *     *
*  *******  ****  *  ****  *  **********  *
*  *                 *                    *
*  *******  ****  ****  *******  ****  *  *
*     *     *           *     *  *     *  *
*******  ****  **********  *******  ****  *
*        *  *  *        *        *  *     *
*  *******  ****  *  *  *******  *  *******
*        *  *     *  *  *  *           *  *
*  ****  *  *  *******  *  *  *  *  ****  *
*     *  *     *              *  *        
****************************************  
