   ****************************
         *           *     *  *
*  *  *  *  ****  *  *  ****  *
*  *  *  *  *     *     *     *
*  *******  *  *  *  *******  *
*     *  *  *  *  *           *
*  ****  *******  **********  *
*           *     *           *
*  ****  **********  *  *******
*  *     *           *  *     *
*  ****  *  *******  ****  ****
*     *  *        *  *  *     *
*  ****  *******  ****  ****  *
*     *                       *
*  ****  *************  *******
*     *     *     *        *  *
*  *  ****  *  ****  *******  *
*  *  *     *                 *
*  ****  **********  *******  *
*     *     *        *        
****************************  


