   **********************************
            *  *     *        *  *  *
*  ****  ****  *  *******  ****  *  *
*  *                    *           *
****  ****  *  *  *************  *  *
*  *  *     *  *     *     *     *  *
*  *  *******************  ****  *  *
*        *  *                    *  *
*  *******  *******************  ****
*        *  *     *     *           *
*******  *  ****  *  *******  *  ****
*     *     *     *           *  *  *
*  ****  *******  ****  *  ****  *  *
*                 *  *  *  *     *  *
****  *******  *  *  *  *******  *  *
*  *  *        *              *     *
*  *************  ****  *  *******  *
*        *           *  *  *        *
*******  ****  *  ****  *  ****  ****
*     *     *  *     *  *  *  *     *
****  ****  *  *  *  *  ****  ****  *
*           *  *  *  *     *        *
*  ****  *  ****  *  **********  ****
*     *  *        *  *              
**********************************  


