   ****************************
      *  *  *  *           *  *
****  *  *  *  **********  *  *
*  *                 *        *
*  *  ****  *  **********  *  *
*     *  *  *        *  *  *  *
*******  *  ****  *  *  *  ****
*  *  *     *     *        *  *
*  *  *  *  **********  ****  *
*  *     *        *  *  *     *
*  **********  *  *  *  *  ****
*  *     *     *  *     *     *
*  ****  ****  *  **********  *
*        *  *  *     *        *
*  ****  *  *  *  *  *******  *
*     *     *  *  *  *  *  *  *
*******  ****  *******  *  *  *
*        *        *     *     *
*******  *  *  ****  *******  *
*           *                 
****************************  


